0
30
-1
23
1111111111111111111111111111111
1111111111111111111111111111111
1111111111111111111111111111111
1111111111111111111111111111111
1111111111111111111111111111111
1111111111111111111111111111111
1111111111111111111111111111111
1111111111111111111111111111111
1111111111111111111111111111111
1200000000000000000001111111111
1000044444444444400001111111111
1000040000000000400001111111111
1000040044444400400001111111111
1000040040000400400001111111111
1000000040000000400001111111111
1000000040000000400001111111111
1000040040000400400001111111111
1000040044444400400001111111111
1000040000000000400001111111111
1000044444444444400001111111111
1000000000000000000001111111111
1000011110000111100031111111111
1111111111111111111111111111111
1111111111111111111111111111111
1111111111111111111111111111111
