0
30
-1
23
1111111111111111111111111111111
1111111111111111111111111111111
1111111111111111111111111111111
1000011110020111100001111111111
1000000000000000000001111111111
1000011110000111100001111111111
1110111111101111111011111111111
1110111111101111111011111111111
1110111111101111111011111111111
1110111111101111111011111111111
1110111111101111111011111111111
1000011114444111100001111111111
1000000000000000000001111111111
1000011110003111100001111111111
1110111111111111111011111111111
1110111111111111111011111111111
1110111111111111111011111111111
1110111111111111111011111111111
1110111111111111111011111111111
1000011110000111100001111111111
1000000000000000000001111111111
1000011110003111100001111111111
1111111111111111111111111111111
1111111111111111111111111111111
1111111111111111111111111111111
