0
15
-1
7
1111111111111111
1111111111111111
1111111111111111
1100004000400011
1100404040404011
1120400040004311
1111111111111111
1111111111111111
1111111111111111
