0
21
-1
23
1111111111111111111111
1111111111111111111111
1111111111111111111111
1120011100011100211111
1100000000000000011111
1100011100011100011111
1110111110111110111111
1110111110111110111111
1110111110111110111111
1110111110111110111111
1100011140411100011111
1100000000000000011111
1100011144411100011111
1114111110111110111111
1114111110111110111111
1114111110111110111111
1110111110111110111111
1100011100011100011111
1100000000000000011111
1130011100011100311111
1111111111111111111111
1111111111111111111111
1111111111111111111111
1111111111111111111111
1111111111111111111111
