0
15
-1
6
1111111111111111
1111111111111111
1111111111111111
1111111111100011
1120000000000311
1111111111100011
1111111111111111
1111111111111111
