0
21
-1
16
1111111111111111111111
1111111111111111111111
1111111111111111111111
1100001110000111000311
1100000000000000000011
1100001110000111000011
1100001110000111000011
1110111111011111101111
1110111111011111101111
1110111111011111101111
1110111111011111101111
1100001110000111000311
1100001110000111000011
1100000000000004000011
1120001110000111000011
1111111111111111111111
1111111111111111111111
1111111111111111111111
