-6
42
-8
32
1111111111111111111111111111111111111111111111111
1111111111111111111111111111111111111111111111111
1111111111111111111111111111111111111111111111111
1111111111111111111111111111111111111111111111111
1111111111111111111111111111111111111111111111111
1111111111111111111111111111111111111111111111111
1111111111111111111111111111111111111111111111111
1111111111111111111111111111111111111111111111111
1111111111111111111111111111111111111111111111111
1111111111111111111111111110031111111111111111111
1111111111111111111111111114001111111111111111111
1111111111111100000311111114001111111111111111111
1111111111111100000011111111011111111111111111111
1111111111111100000011111111011111111111111111111
1111111111111100000011111111011111111111111111111
1111111111111101111111111111011111111111111111111
1111111111111101111111111111011111111111111111111
1111111111111101111111111111011111111111111111111
1111111111111101111111111111011111111111111111111
1111111111111100000000001111011111111111111111111
1111111111111111111100400000001111111111111111111
1111111111111111111100001111101111111111111111111
1111111111111111111111111111101111111111111111111
1111111111111111111111111111101111111111111111111
1111111111111111111111111111101111111111111111111
1111111111111111111111111111101111111111111111111
1111111110000111111111111111101111111111111111111
1111111112040000000000000000001111111111111111111
1111111110000111111111111111111111111111111111111
1111111111111111111111111111111111111111111111111
1111111111111111111111111111111111111111111111111
1111111111111111111111111111111111111111111111111
1111111111111111111111111111111111111111111111111
1111111111111111111111111111111111111111111111111
1111111111111111111111111111111111111111111111111
1111111111111111111111111111111111111111111111111
1111111111111111111111111111111111111111111111111
1111111111111111111111111111111111111111111111111
1111111111111111111111111111111111111111111111111
1111111111111111111111111111111111111111111111111
1111111111111111111111111111111111111111111111111
