0
21
-1
23
1111111111111111111111
1111111111111111111111
1111111111111111111111
1120001111111111111111
1100001111111111111111
1100001111111111111111
1110111111111111111111
1110111111111111111111
1110111111111111111111
1110111111111111111111
1100001110000111111111
1100000000000111111111
1100001110000111111111
1100001110000111111111
1110111111101111111111
1110111111101111111111
1110111111101111111111
1110111111101111111111
1100001110000111111111
1100001110440111111111
1100000000440111111111
1100001110003111111111
1111111111111111111111
1111111111111111111111
1111111111111111111111
