0
30
-1
23
1111111111111111111111111111111
1111111111111111111111111111111
1111111111111111111111111111111
1111111111111111111111111111111
1111111111111111111111111111111
1111111111111111111111111111111
1111111111111111111111111111111
1111111111111111111111111111111
1111111111111111111111111111111
1000110021111111111111111111111
1000110001111111111111111111111
1000000001111111111111111111111
1000110001111111111111111111111
1000110001111111111111111111111
1000110001111111111111111111111
1000110001111111111111111111111
1000110001111111111111111111111
1000110001111111111111111111111
1000110001111111111111111111111
1000000001111111111111111111111
1000110001111111111111111111111
1300110001111111111111111111111
1111111111111111111111111111111
1111111111111111111111111111111
1111111111111111111111111111111
