0
30
-1
23
1111111111111111111111111111111
1111111111111111111111111111111
1111111111111111111111111111111
1111111111111111111111111111111
1111111111111111111111111111111
1111111111111111111111111111111
1111111111111111111111111111111
1111111111111111111111111111111
1111111111111111111111111111111
1200110001100011000110001111111
1000110000000011000000001111111
1000110001100011000114401111111
1000110001100011000110001111111
1000110001100011000110001111111
1000110001100011000110441111111
1000110001100011000110001111111
1000110001100011000110001111111
1000110001100011000110001111111
1000110001100011000114401111111
1000000001100000000110001111111
1000110001100011000110001111111
1000110001100011000110031111111
1111111111111111111111111111111
1111111111111111111111111111111
1111111111111111111111111111111
