0
30
-1
23
1111111111111111111111111111111
1111111111111111111111111111111
1111111111111111111111111111111
1111111111111111111111111111111
1111111111111111111111111111111
1111111111111111111111111111111
1111111111111111111111111111111
1111111111111111111111111111111
1111111111111111111111111111111
1200110001100011003111111111111
1000110001100011000111111111111
1000000000000000000111111111111
1000110001100011000111111111111
1000110001100011000111111111111
1000110001100011000111111111111
1000110001100011000111111111111
1000110001100011000111111111111
1000110001100011000111111111111
1000110001100011000111111111111
1000000000000000000111111111111
1000110001100011000111111111111
1200110001100011003111111111111
1111111111111111111111111111111
1111111111111111111111111111111
1111111111111111111111111111111
