0
30
-1
23
1111111111111111111111111111111
1111111111111111111111111111111
1111111111111111111111111111111
1111111111111111111111111111111
1111111111111111111111111111111
1111111111111111111111111111111
1111111111111111111111111111111
1111111111111111111111111111111
1111111111111111111111111111111
1111111111111111111111111111111
1111111111111111111111111111111
1000011110020111100001111111111
1000000000000000000001111111111
1000011110000111100001111111111
1110111111111111111011111111111
1110111111111111111011111111111
1110111111111111111011111111111
1110111111111111111011111111111
1110111111111111111011111111111
1000011114004111100001111111111
1000000004004000000001111111111
1300011114004111100031111111111
1111111111111111111111111111111
1111111111111111111111111111111
1111111111111111111111111111111
