0
21
-1
23
1111111111111111111111
1111111111111111111111
1111111111111111111111
1130411144411140311111
1140044440444400411111
1144004444444004411111
1114404444444044111111
1114404444444044111111
1114404444444044111111
1114400444440044111111
1144440000000444411111
1140444020204440411111
1144440000000444411111
1114440444440444111111
1114400444440044111111
1114404444444044111111
1114404444444044111111
1144004444444004411111
1140044440444400411111
1130411144411140311111
1111111111111111111111
1111111111111111111111
1111111111111111111111
1111111111111111111111
1111111111111111111111
