0
21
-1
23
1111111111111111111111
1111111111111111111111
1111111111111111111111
1130011100011100311111
1100000000000000011111
1100000000000000011111
1110000000000000111111
1110000000000000111111
1110000000000000111111
1110000000000000111111
1100000000000000011111
1100000020200000011111
1100000000000000011111
1110000000000000111111
1110000000000000111111
1110000000000000111111
1110000000000000111111
1100000000000000011111
1100000000000000011111
1130011100011100311111
1111111111111111111111
1111111111111111111111
1111111111111111111111
1111111111111111111111
1111111111111111111111
