0
30
-1
23
1111111111111111111111111111111
1111111111111111111111111111111
1111111111111111111111111111111
1111111111111111111111111111111
1111111111111111111111111111111
1111111111111111111111111111111
1111111111111111111111111111111
1111111111111111111111111111111
1111111111111111111111111111111
1200110001100311111111111111111
1000110001100011111111111111111
1000000000000011111111111111111
1000110001100011111111111111111
1000110001100011111111111111111
1000110001100011111111111111111
1000110001100011111111111111111
1000110001100011111111111111111
1000110001100011111111111111111
1000110001100011111111111111111
1000000000000011111111111111111
1000110001100011111111111111111
1200110001100311111111111111111
1111111111111111111111111111111
1111111111111111111111111111111
1111111111111111111111111111111
