0
30
-1
23
1111111111111111111111111111111
1111111111111111111111111111111
1111111111111111111111111111111
1111111111111111111111111111111
1111111111111111111111111111111
1111111111111111111111111111111
1111111111111111111111111111111
1111111111111111111111111111111
1111111111111111111111111111111
1111111111111111111111111111111
1111111111111111111111111111111
1111111111111111111111111111111
1111111111111111111111111111111
1111111111111111111111111111111
1111111111111111111000311111111
1111111111111111111044411111111
1111111111111111111000011111111
1111111111111111111444011111111
1111111111111111111000011111111
1000011111100001111044411111111
1000000000004400000000011111111
1200011111100031111000011111111
1111111111111111111111111111111
1111111111111111111111111111111
1111111111111111111111111111111
