0
30
-1
23
1111111111111111111111111111111
1111111111111111111111111111111
1111111111111111111111111111111
1111111111111111111111111111111
1111111111111111111111111111111
1111111111111111111111111111111
1111111111111111111111111111111
1111111111111111111111111111111
1200111111100011111111111111111
1000000000000011111111111111111
1000111111100011111111111111111
1101111111110111111111111111111
1101111111110111111111111111111
1101111111110111111111111111111
1101111111110111111111111111111
1000000011110111111111111111111
1000000011110111111111111111111
1000000011110111111111111111111
1000000011110111111111111111111
1000000011100011111111111111111
1000000000000011111111111111111
1000000011100311111111111111111
1111111111111111111111111111111
1111111111111111111111111111111
1111111111111111111111111111111
