0
30
-1
23
1111111111111111111111111111111
1111111111111111111111111111111
1111111111111111111111111111111
1111111111111111111111111111111
1111111111111111111111111111111
1111111111111111111111111111111
1111111111111111111111111111111
1111111111111111111111111111111
1111111111111111111111111111111
1400011110002111100031111111111
1404011110000111100001111111111
1404011110000111100001111111111
1404011110000111100001111111111
1404011110000111100001111111111
1404011110000111100001111111111
1404011110000111100001111111111
1404011110000111100001111111111
1404011110000111100001111111111
1404011110000111100001111111111
1404011110000111100001111111111
1404000000000000000001111111111
1304011110000111100001111111111
1111111111111111111111111111111
1111111111111111111111111111111
1111111111111111111111111111111
