-3
30
-1
27
0000000000000000000000000000000000
0000000000000000000000000000000000
0011111111111111111111111111111111
0011111111111111111111111111111111
0011111111111111111111111111111111
0011111111111111111111111111111111
0011111111111111111111111111111111
0011111111111111111111111111111111
0011111111111111111111111111111111
0011111111111111111111111111111111
0011111111111111111111111111111111
0011111111111111111111111111111111
0011111111111111111111111111111111
0011111111111111111111111111111111
0011111111111111111111000000001111
0011300011111200011111000000001111
0011000011111000000000000000001111
0011000011111000011111444400001111
0011101111111101111111000000001111
0011101111111101111111000000001111
0011101111111101111111000000001111
0011101111111101111111000044441111
0011101111111101111111000000001111
0011000011111000011111000000001111
0011000000000000011111000000031111
0011000011111000011111111111111111
0011111111111111111111111111111111
0011111111111111111111111111111111
0011111111111111111111111111111111
