-5
42
-8
32
000000000000000000000000000000000000000000000000
000000000000000000000000000000000000000000000000
000000000000000000000000000000000000000000000000
000000000000000000000000000000000000000000000000
000000000000000000000000000000000000000000000000
000000000000000000000000000000000000000000000000
000000000000000000000000000000000000000000000000
000011111111111111111111111111111111111000000000
000011111111111111111111111111111111111000000000
000011111111111111111111111111111111111000000000
000011200011111000011111111111111111111000000000
000011000011111000311111111111111111111000000000
000011000011111000011100011111111111111000000000
000011101111111411111100011111111111111000000000
000011101111111011111100011111111111111000000000
000011101111111011111110111111111111111000000000
000011101111111011111110111111111111111000000000
000011101111111011111110111111111111111000000000
000011101111111011111110111111111111111000000000
000011000011111011111110111111111111111000000000
000011000000000000000000111111111111111000000000
000011000011111011111110111111111111111000000000
000011101111111011111110111111111111111000000000
000011101111111011111110111111111111111000000000
000011101111111011111110111111111111111000000000
000011101111111011111100011111111111111000000000
000011101111111411111100011111111111111000000000
000011101111111011111100311111111111111000000000
000011000011111000011111111111111111111000000000
000011000011111000011111111111111111111000000000
000011000011111000011111111111111111111000000000
000011111111111111111111111111111111111000000000
000011111111111111111111111111111111111000000000
000011111111111111111111111111111111111000000000
000000000000000000000000000000000000000000000000
000000000000000000000000000000000000000000000000
000000000000000000000000000000000000000000000000
000000000000000000000000000000000000000000000000
000000000000000000000000000000000000000000000000
000000000000000000000000000000000000000000000000
000000000000000000000000000000000000000000000000
