-5
39
-6
32
000000000000000000000000000000000000000000000
000000000000000000000000000000000000000000000
000000000000000000000000000000000000000000000
000011111111111111111111111111111111111000000
000011111111111111111111111111111111111000000
000011111111111111111111111111111111111000000
000011111111111111111111111111111111111000000
000011111111111111111111111111111111111000000
000011111111111111111111111111111111111000000
000011111111111111111111111111111111111000000
000011111111111111111111111111111111111000000
000011111111300111110001111111111111111000000
000011111111000111110001111111111111111000000
000011111111000111110001111111111111111000000
000011111111101111111011111111111111111000000
000011111111101111111011111111111111111000000
000011111111101111111011111111111111111000000
000011111111101111111011111111111111111000000
000011111111101111111011111111111111111000000
000011111110000011100000111111111111111000000
000011111110111011101110111000000111111000000
000011111110111011101110111004000111111000000
000011111110111011101110000040000111111000000
000011111110111011101110000400000111111000000
000011111110111011101110111000000111111000000
000011111110111011101110111000000111111000000
000011111110111011101110111111111111111000000
000011111110111011101110111111111111111000000
000011111200111000001113111111111111111000000
000011111111111111111111111111111111111000000
000011111111111111111111111111111111111000000
000011111111111111111111111111111111111000000
000011111111111111111111111111111111111000000
000011111111111111111111111111111111111000000
000011111111111111111111111111111111111000000
000000000000000000000000000000000000000000000
000000000000000000000000000000000000000000000
000000000000000000000000000000000000000000000
000000000000000000000000000000000000000000000
