0
30
-1
23
1111111111111111111111111111111
1111111111111111111111111111111
1111111111111111111111111111111
1111111111111111111111111111111
1111111111111111111111111111111
1300000000000000311111111111111
1444400000000444411111111111111
1000000000000000011111111111111
1000000000000000011111111111111
1000000000000000011111111111111
1000000000000000011111111111111
1000000000000000011111111111111
1000000000000000011111111111111
1000000000000000011111111111111
1000000000000000011111111111111
1000000000000000011111111111111
1000000000000000011111111111111
1000000000000000011111111111111
1000000000000000011111111111111
1000000000000000011111111111111
1000000022000000011111111111111
1000000000000000011111111111111
1111111111111111111111111111111
1111111111111111111111111111111
1111111111111111111111111111111
