0
30
-1
23
1111111111111111111111111111111
1111111111111111111111111111111
1111111111111111111111111111111
1111111111111111111111111111111
1111111111111111111111111111111
1111111111111111111111111111111
1111111111111111111111111111111
1111111111111111111111111111111
1111111111111111111111111111111
1111111111111111111111111111111
1111111111111111111111111111111
1111111111111111111111111111111
1020111000111000111000111111111
1000000000000000000003111111111
1000111000111000111000111111111
1101111101111141111101111111111
1101111101111141111101111111111
1101111101111141111101111111111
1101111101111141111101111111111
1000111000111000111000111111111
1000000000000000000000111111111
1200111000111000111003111111111
1111111111111111111111111111111
1111111111111111111111111111111
1111111111111111111111111111111
