-5
39
-6
32
000000000000000000000000000000000000000000000
000000000000000000000000000000000000000000000
000000000000000000000000000000000000000000000
000000000000000000000000000000000000000000000
000000000000000000000000000000000000000000000
000000000000000000000000000000000000000000000
000000000000000000000000000000000000000000000
000011111111111111111111111111111111111000000
000011111111111111111111111111111111111000000
000011111111111111111111111111111111111000000
000011200011111000011111000011111003011000000
000011000000000000000000000000000000011000000
000011000011111000011111000011111000011000000
000011101111111101111111101111111101111000000
000011101111111101111111101111111101111000000
000011101111111101111111101111111101111000000
000011101111111101111111101111111101111000000
000011101111111101111111101111111101111000000
000011101111111101111111101111111101111000000
000011000011111000011111000011111000011000000
000011000000000044400000044400000000011000000
000011000011111000011111000011111000011000000
000011101111111101111111101111111101111000000
000011101111111101111111101111111101111000000
000011101111111101111111101111111101111000000
000011101111111101111111101111111101111000000
000011101111111101111111101111111101111000000
000011101111111101111111101111111101111000000
000011000011111000011111000011111000011000000
000011000000000000000000000000000000311000000
000011000011111000011111000011111000011000000
000011111111111111111111111111111111111000000
000011111111111111111111111111111111111000000
000011111111111111111111111111111111111000000
000000000000000000000000000000000000000000000
000000000000000000000000000000000000000000000
000000000000000000000000000000000000000000000
000000000000000000000000000000000000000000000
000000000000000000000000000000000000000000000
