0
30
-1
23
1111111111111111111111111111111
1111111111111111111111111111111
1111111111111111111111111111111
1111111111111111111111111111111
1111111111111111111111111111111
1003011000011003011111111111111
1000011000011000011111111111111
1000011000011000011111111111111
1101111101111101111111111111111
1101111101111101111111111111111
1101111101111101111111111111111
1101111101111101111111111111111
1000111000111000111111111111111
1000444000444000111111111111111
1000111000111000111111111111111
1101111101111101111111111111111
1101111101111101111111111111111
1101111101111101111111111111111
1101111101111101111111111111111
1000111000111000111111111111111
1000000020000000111111111111111
1000111000111000111111111111111
1111111111111111111111111111111
1111111111111111111111111111111
1111111111111111111111111111111
