-5
39
-6
32
000000000000000000000000000000000000000000000
000000000000000000000000000000000000000000000
000000000000000000000000000000000000000000000
000011111111111111111111111111111111111000000
000011111111111111111111111111111111111000000
000011111111111111111111111111111111111000000
000011111111111111111111111111111111111000000
000011111111111111111111111111111111111000000
000011111111111111111111111111111111111000000
000011111111111111111111111111111111111000000
000011111111111111111111111111111111111000000
000011000111111111100311111111111111111000000
000011000111111111100011111111111111111000000
000011000111111111100011111111111111111000000
000011101111111111110111111111111111111000000
000011101111111111110111111111111111111000000
000011101111111111110111111111111111111000000
000011101111111111110111111111111111111000000
000011100000000000000111111111111111111000000
000011111111011111111111111111111111111000000
000011111111011111111111111111111111111000000
000011111111011111111111111111111111111000000
000011111111011111111111111111111111111000000
000011111111011111111111111111111111111000000
000011111111011111111111111111111111111000000
000011120000000000000000000000111111111000000
000011101111111111111111111110111111111000000
000011101111111111111111111110111111111000000
000011101111111111111111111110111111111000000
000011101111111111111111111110111111111000000
000011101111111111111111111110111111111000000
000011130000000000000000000000111111111000000
000011111111111111111111111111111111111000000
000011111111111111111111111111111111111000000
000011111111111111111111111111111111111000000
000000000000000000000000000000000000000000000
000000000000000000000000000000000000000000000
000000000000000000000000000000000000000000000
000000000000000000000000000000000000000000000
