-5
31
-1
30
0000000000000000000000000000000000000
0000111111111111111111111111111111111
0000111111111111111111111111111111111
0000111111111111111300001111111111111
0000111111111111111000001111111111111
0000111111111111111000001111111111111
0000111111111111111100011111111111111
0000111111111111111100011111111111111
0000111111111111111100011111111111111
0000111111111111111100011111111111111
0000111111111111111000001111111111111
0000111111111111111000001111111111111
0000111111111111111000001111111111111
0000111111111111111000001111111111111
0000111100011110000000000000111100011
0000111100000040000000000000400000011
0000111100000040000000000000400000011
0000111100000040000000000000400000011
0000111100011110000000000000111100011
0000111100011110000000000000111100011
0000111111111111111000001111111111111
0000111111111111111000001111111111111
0000111111111111111000001111111111111
0000111111111111111100011111111111111
0000111111111111111100011111111111111
0000111111111111111100011111111111111
0000111111111111111100011111111111111
0000111111111111111000001111111111111
0000111111111111111002001111111111111
0000111111111111111000001111111111111
0000111111111111111111111111111111111
0000111111111111111111111111111111111
