-5
31
-6
32
0000000000000000000000000000000000000
0000000000000000000000000000000000000
0000000000000000000000000000000000000
0000111111111111111111111111111111111
0000111111111111111111111111111111111
0000111111111111111111111111111111111
0000111111111111111111111111111111111
0000111111111111111111111111111111111
0000111111111111111111111111111111111
0000111111111111111111111111111111111
0000111111111111111111111111111111111
0000111111111111111111111111111111111
0000111111111111111111111111111111111
0000111111111111111111111111111111111
0000111111111111111111111111111111111
0000111111111111111111111111111111111
0000111100011110000000000000111100011
0000111100000000000000000000000000011
0000111100000000000000000000000000011
0000111100000000000000000000000000011
0000111100011110000000000000111100011
0000111100011110000000000000111100011
0000111110111111111000001111111110111
0000111110111111111000001111111110111
0000111110111111111000001111111110111
0000111110111111111100011111111110111
0000111110111111111100011111111110111
0000111110111111111100011111111110111
0000111100011111111100011111111100011
0000111100011111111000001111111100011
0000111100011111111002001111111100011
0000111100011111111000001111111100011
0000111103011111111111111111111103011
0000111111111111111111111111111111111
0000111111111111111111111111111111111
0000000000000000000000000000000000000
0000000000000000000000000000000000000
0000000000000000000000000000000000000
0000000000000000000000000000000000000
