-3
31
-1
28
00000000000000000000000000000000000
00111111111111111111111111111111111
00111111111111111111111111111111111
00111111003001111111111111111111111
00111111000001111111111111111111111
00111111100011111111111111111111111
00111111100011111111111111111111111
00111111100011111111111111111111111
00111111100011111111111111111111111
00111110000000111111111111111111111
00111110000000111111111111111111111
00110000000000000111111111111111111
00110000000000000111111111111111111
00110000000000000111111111111111111
00110000000000000111111111111111111
00110000000000000111111111111111111
00110000000000000111111000011111111
00110000000000000111111000011111111
00110000000000000111111000011111111
00111011111111011111111101111111111
00111011111111011111111101111111111
00111011111111011111111101111111111
00111011111111011111111101111111111
00111011111111011111111101111111111
00110000111110000111111000111100011
00110000000000000000000000000000211
00110000111110000111111000111100011
00111111111111111111111111111111111
00111111111111111111111111111111111
00111111111111111111111111111111111
