-5
39
-6
32
000000000000000000000000000000000000000000000
000000000000000000000000000000000000000000000
000000000000000000000000000000000000000000000
000011111111111111111111111111111111111000000
000011111111111111111111111111111111111000000
000011111111111111111111111111111111111000000
000011111111111111111111111111111111111000000
000011111111111111111111111111111111111000000
000011111111111111111111111111111111111000000
000011111111111111111111111111111111111000000
000011111111111111111111111111111111111000000
000011111111111111111111111111111111111000000
000011111111111111111111111111111111111000000
000011111111111111111111111111111111111000000
000011111300000000000000001111111111111000000
000011111111111111111111101111111111111000000
000011111111111111111111101111111111111000000
000011111111111111111111101111111111111000000
000011111111111111111111101111111111111000000
000011111000000000000000001111111111111000000
000011111011111111111111111111111111111000000
000011111011111111111111111111111111111000000
000011111011111111111111111111111111111000000
000011111011111111111111111111111111111000000
000011111011111111111111111111111111111000000
000011111011111111111111111111111111111000000
000011111000000000000000021111111111111000000
000011111111111111111111111111111111111000000
000011111111111111111111111111111111111000000
000011111111111111111111111111111111111000000
000011111111111111111111111111111111111000000
000011111111111111111111111111111111111000000
000011111111111111111111111111111111111000000
000011111111111111111111111111111111111000000
000011111111111111111111111111111111111000000
000000000000000000000000000000000000000000000
000000000000000000000000000000000000000000000
000000000000000000000000000000000000000000000
000000000000000000000000000000000000000000000
