-3
30
-1
27
0000000000000000000000000000000000
0000000000000000000000000000000000
0011111111111111111111111111111111
0011111111111111111111111111111111
0011111111111111111111111111111111
0011111111111111111111111111111111
0011111111111111111111111111111111
0011111111111111111111111111111111
0011111111111111111111111111111111
0011111111111111111111111111111111
0011111111111111111111111111111111
0011111111111111111111111111111111
0011111111111111111111111111111111
0011111111111111111111111111111111
0011111111111111111111111111111111
0011200011111000011111111111111111
0011000000000000011111111111111111
0011000011111000011111111111111111
0011101111111101111111111111111111
0011101111111101111111111111111111
0011101111111101111111111111111111
0011101111111101111111111111111111
0011101111111101111111111111111111
0011000011111000011111111111111111
0011000000040000011111111111111111
0011000011111000311111111111111111
0011111111111111111111111111111111
0011111111111111111111111111111111
0011111111111111111111111111111111
