-5
39
-6
32
000000000000000000000000000000000000000000000
000000000000000000000000000000000000000000000
000000000000000000000000000000000000000000000
000011111111111111111111111111111111111000000
000011111111111111111111111111111111111000000
000011111111111111111111111111111111111000000
000011111111111111111111111111111111111000000
000011111111111111111111111111111111111000000
000011111111111111111111111111111111111000000
000011000040000011111111111111111111111000000
000011000111111011111111111111111111111000000
000011300111111011111111111111111111111000000
000011111111111411111111111111111111111000000
000011111111111011111111111111111111111000000
000011111111000000011111111111111111111000000
000011111111000000011111111111111111111000000
000011111111000000011111111111111111111000000
000011111111111011111113001111111111111000000
000011111111111011111110001111111111111000000
000011111111111011111110001111111111111000000
000011111111111011111111011111111111111000000
000011111111111011111111011111111111111000000
000011111111111011111111011111111111111000000
000011111111111011111111011111111111111000000
000011111111111011111111011111111111111000000
000011111111111011111111011111111111111000000
000011000011111011111000000111111111111000000
000011000011111011111000000111111111111000000
000011000000000000000000000111111111111000000
000011000000000000000000000111111111111000000
000011000011111111111000000111111111111000000
000011200011111111111000000111111111111000000
000011111111111111111111111111111111111000000
000011111111111111111111111111111111111000000
000011111111111111111111111111111111111000000
000000000000000000000000000000000000000000000
000000000000000000000000000000000000000000000
000000000000000000000000000000000000000000000
000000000000000000000000000000000000000000000
