-3
30
-1
27
0000000000000000000000000000000000
0000000000000000000000000000000000
0011111111111111111111111111111111
0011111111111111111111111111111111
0011111111111111111111111111111111
0011111111111111111111111111111111
0011111111111111111111111111111111
0011111111111111111111111111111111
0011111111111111111111111111111111
0011111111111111111111111111111111
0011111111111111111111111111111111
0011111111111111111111111111111111
0011111111111111111111111111111111
0011111111111111111111111111111111
0011111111111111111111111111111111
0011300011111200011111300011111111
0011440011111000011111440011111111
0011000011111000011111000011111111
0011101111111101111111101111111111
0011101111111101111111101111111111
0011101111111101111111101111111111
0011101111111101111111101111111111
0011101111111101111111101111111111
0011000011111000011111000011111111
0011000000000000000000000011111111
0011000011111000011111000011111111
0011111111111111111111111111111111
0011111111111111111111111111111111
0011111111111111111111111111111111
