-5
39
-6
32
000000000000000000000000000000000000000000000
000000000000000000000000000000000000000000000
000000000000000000000000000000000000000000000
000011111111111111111111111111111111111000000
000011111111111111111111111111111111111000000
000011111111111111111111111111111111111000000
000011111111111111111111111111111111111000000
000011111111111111111111111111111111111000000
000011111111111111111111111111111111111000000
000011111111111111111111111111111111111000000
000011111111111111111111111111111111111000000
000011111111111111111111111111111111111000000
000011111111111111111111111111111111111000000
000011111111111111111111111111111111111000000
000011111111111111111111111111111111111000000
000011111111111111111111111111111111111000000
000011111111111111111111111111111111111000000
000011111111111111111111111111111111111000000
000011111111111111111111111111111111111000000
000011111111111111111111111111111111111000000
000011111111111111111111111111111111111000000
000011111111111111111111111111111111111000000
000011111111111111111111111111111111111000000
000011111111111111111111111111111111111000000
000011111111111111111111111111111111111000000
000011130000000000000000000000111111111000000
000011111111111111111111111110111111111000000
000011111111111111111111111110111111111000000
000011111111111111111111111110111111111000000
000011111111111111111111111110111111111000000
000011111111111111111111111110111111111000000
000011120000000000000000000000111111111000000
000011111111111111111111111111111111111000000
000011111111111111111111111111111111111000000
000011111111111111111111111111111111111000000
000000000000000000000000000000000000000000000
000000000000000000000000000000000000000000000
000000000000000000000000000000000000000000000
000000000000000000000000000000000000000000000
