-5
39
-6
32
000000000000000000000000000000000000000000000
000000000000000000000000000000000000000000000
000000000000000000000000000000000000000000000
000011111111111111111111111111111111111000000
000011111111111111111111111111111111111000000
000011111111111111111111111111111111111000000
000011111111111111111111111111111111111000000
000011111111111111111111111111111111111000000
000011111111111111111111111111111111111000000
000011111111111111111111111111111111111000000
000011111111111111111111111111111111111000000
000011110000111100001111111111111111111000000
000011110000111100001111111111111111111000000
000011110000111100001111111111111111111000000
000011111011111110111111111111111111111000000
000011111011111110111111111111111111111000000
000011111011111110111111111111111111111000000
000011111011111110111111111111111111111000000
000011111011111110111111000011111111111000000
000011111000000000000000000211111111111000000
000011111011111110111111000011111111111000000
000011111011111110111111111111111111111000000
000011111011111110111111111111111111111000000
000011111011111110111111111111111111111000000
000011111011111110111111111111111111111000000
000011110001111100011111111111111111111000000
000011110001111100011111111111111111111000000
000011110031111100011111111111111111111000000
000011111111111111111111111111111111111000000
000011111111111111111111111111111111111000000
000011111111111111111111111111111111111000000
000011111111111111111111111111111111111000000
000011111111111111111111111111111111111000000
000011111111111111111111111111111111111000000
000011111111111111111111111111111111111000000
000000000000000000000000000000000000000000000
000000000000000000000000000000000000000000000
000000000000000000000000000000000000000000000
000000000000000000000000000000000000000000000
