-3
31
-1
27
00000000000000000000000000000000000
00000000000000000000000000000000000
00111111111111111111111111111111111
00111111111111111111111111111111111
00111111111111111111111111111111111
00111111111111111111111111111111111
00111111111111111111111111111111111
00110000111110000111111000011111111
00113000000000000000000000011111111
00110000111110000111111000011111111
00111111111111111111111101111111111
00111111111111111111111101111111111
00111111111111111111111101111111111
00111111111111111111111101111111111
00111111111111111111111101111111111
00110000111110000111111000011111111
00110000000000000111111000011111111
00110000111110000111111000011111111
00111011111111011111111101111111111
00111011111111011111111101111111111
00111011111111011111111101111111111
00111011111111411111111101111111111
00111011111111411111111101111111111
00110000111110000111111000111100011
00110000000440000000000000000000211
00110000111110000111111000111100011
00111111111111111111111111111111111
00111111111111111111111111111111111
00111111111111111111111111111111111
