-5
39
-6
32
000000000000000000000000000000000000000000000
000011111111111111111111111111111111111000000
000011111111111111111111111111111111111000000
000011111111111111111003111111111111111000000
000011111111111000000000111111111111111000000
000011111111111011111000111111111111111000000
000011111111111011111111111111111111111000000
000011111111111011111111111111111111111000000
000011111111111011111111111111111111111000000
000011000000000011111111111111111111111000000
000011000111111011111111111111111111111000000
000011000111111011111111111111111111111000000
000011111111111011111111111111111111111000000
000011111111111011111111111111111111111000000
000011111111000011111111111111111111111000000
000011111111000011111000111111111111111000000
000011111111000000000000111111111111111000000
000011111111000011111002111111111111111000000
000011111111111111111111111111111111111000000
000011111111111111111111111111111111111000000
000011111111111111111111111111111111111000000
000011111111111111111111111111111111111000000
000011111111111111111111111111111111111000000
000011111111111111111111111111111111111000000
000011111111111111111111111111111111111000000
000011111111111111111111111111111111111000000
000011111111111111111111111111111111111000000
000011111111111111111111111111111111111000000
000011111111111111111111111111111111111000000
000011111111111111111111111111111111111000000
000011111111111111111111111111111111111000000
000011111111111111111111111111111111111000000
000011111111111111111111111111111111111000000
000011111111111111111111111111111111111000000
000011111111111111111111111111111111111000000
000000000000000000000000000000000000000000000
000000000000000000000000000000000000000000000
000000000000000000000000000000000000000000000
000000000000000000000000000000000000000000000
