-5
39
-6
32
000000000000000000000000000000000000000000000
000000000000000000000000000000000000000000000
000000000000000000000000000000000000000000000
000011111111111111111111111111111111111000000
000011111111111111111111111111111111111000000
000011111111111111111111111111111111111000000
000011111111111111111111111111111111111000000
000011111111111111111111111111111111111000000
000011111111111111111111111111111111111000000
000011111111111111111111111111111111111000000
000011111111111111111111111111111111111000000
000011111111111111111111111111111111111000000
000011111111111111111111111111111111111000000
000011111111111111111111111111111111111000000
000011111111000200011111111111111111111000000
000011111111000000011111111111111111111000000
000011111111000000011111111111111111111000000
000011111111111011111111111111111111111000000
000011111111111011111111111111111111111000000
000011300011111011111000003111111111111000000
000011000011111011111000000111111111111000000
000011000011111011111000000111111111111000000
000011110111111011111111011111111111111000000
000011110111111011111111011111111111111000000
000011110111111011111111011111111111111000000
000011110111111011111111011111111111111000000
000011000011111011111000000111111111111000000
000011044411111011111444000111111111111000000
000011000000000000000000000111111111111000000
000011000000000000000000000111111111111000000
000011000011111111111000000111111111111000000
000011000011111111111000000111111111111000000
000011111111111111111111111111111111111000000
000011111111111111111111111111111111111000000
000011111111111111111111111111111111111000000
000000000000000000000000000000000000000000000
000000000000000000000000000000000000000000000
000000000000000000000000000000000000000000000
000000000000000000000000000000000000000000000
